##### ##############################################################
#.S.###........#...................................................####
#..............#......................................................#
##########D#####......................................................#
         #.#   ##...................###########DD############.........#
         #.#    #...................#"""""""""""""""""""""""#.........#
         #.#    #...................#""""^^"""""""""""""""""#.........#
##########D######...................#"""^""""""~~~~"""""""""#.........#
#...................................#""""""""~~~~~~~~~""""""#.........#
#.....[]....#####...................#""""""~~~~~~~~~~"""""""#.........#
#.....##....#   #...................#""""""~~~~~~~~"""""""""#.........#
#############   #...................#"""""""""""~~~"""""""""#.........#
                #...................#^^"""""""""""""""""""""#.........#
   ^^^^^ ^^     #...................#########################.........#
   ^^^^^^^      #.....................................................#
      ^^        #.....................................................#
     ^^^^^      #.....................................................#
                #######################################################