##### ##############################################################         
#.S.###........#...................................................######### 
#..............#............................................................#
##########D#####..........................................................## 
         #.#   ##...................###########DD############............#   
         #.#    #...................#"""""""""""""""""""""""#............#   
         #.#    #...................#""""^^"""""""""""""""""#.............## 
##########D######...................#"""^""""""~~~~"""""""""#..............# 
#...................................D""""""""~~~~~~~~~""""""D..............# 
#.....[]....#####...................D""""""~~~~~~~~~~"""""""D..............# 
#.....##....#   #...................#""""""~~~~~~~~"""""""""#..............# 
#############   #...................#"""""""""""~~~"""""""""#..............# 
                #...................#^^"""""""""""""""""""""#.............#  
   ^^^^^ ^^     #...................###########DD############............#   
   ^^^^^^^      #.......................................................#    
      ^^        #......................................................#     
     ^^^^^      #.....................................................#      
                #######################################################      