##### ##############################################################
#.S.###........#...................................................####
#..............#......................................................#
##########D#####......................................................#
         #.#   ##..................(-------------------------)........#
         #.#    #...................|..\..............................#
         #.#    #...................|...\.............................#
##########D######...................|....\............................#
#.........................................\...........................#
#.....[]....#####........................./...........................#
#.....##....#   #......................../............................#
#############   #......................./.............................#
                #....................../..............................#
   ^^^^^ ^^     #...................../...............................#
   ^^^^^^^      #.....................................................#
      ^^        #.....................................................#
     ^^^^^      #.....................................................#
                #######################################################